convnext jammer|convnext jammer|general
multi-chiplet numa|multi-chiplet numa|general
poland sagemaker|poland sagemaker|general
bias-corrected cfc|bias-corrected cfc|general
cosmology minkowski|cosmology minkowski|general
eigenvectors uncommon|eigenvectors uncommon|general
buyer transactions|buyer transactions|general
disaggregation-level threatens|disaggregation-level threatens|general
feedforward qwen3-30b|feedforward qwen3-30b|general
chivit re|chivit re|general
honest intra-cluster|honest intra-cluster|general
explained predictive-distribution|explained predictive-distribution|general
etg wendelstein|etg wendelstein|general
intention sentence-t5|intention sentence-t5|general
provisioning time-to-first-token|provisioning time-to-first-token|general
conjectures randomly|conjectures randomly|general
antibacterial escape|antibacterial escape|general
aapl cross-dataset|aapl cross-dataset|general
mastery non-interpretable|mastery non-interpretable|general
distributing zero-effort-miss|distributing zero-effort-miss|general
5-3 unmet|5-3 unmet|general
circular locomotion|circular locomotion|general
contend machine-readable|contend machine-readable|general
east state-level|east state-level|general
habitats hotspot|habitats hotspot|general
activity-based gaap|activity-based gaap|general
bundling stays|bundling stays|general
bit-sliced manhattan|bit-sliced manhattan|general
convlstm diurnal|convlstm diurnal|general
intensity-modulated phoenix|intensity-modulated phoenix|general
leak muse|leak muse|general
developments landings|developments landings|general
lhr rtog|lhr rtog|general
arrange junction|arrange junction|general
cal-ql off-the-shelf|cal-ql off-the-shelf|general
collapsing low-probability|collapsing low-probability|general
dsm encompass|dsm encompass|general
compactness enns|compactness enns|general
calcium ctu-13|calcium ctu-13|general
homeostatic pole|homeostatic pole|general
contact locally-learned|contact locally-learned|general
informing prediabetes|informing prediabetes|general
acceptance initialize|acceptance initialize|general
earth-moon station-keeping|earth-moon station-keeping|general
categorizes public-facing|categorizes public-facing|general
emphasis mahalanobis|emphasis mahalanobis|general
contend mayhave|contend mayhave|general
post-unlearning truly|post-unlearning truly|general
adaptive-sensorless sensorless|adaptive-sensorless sensorless|general
hotspots threatened|hotspots threatened|general
